#Name	VCF_annotation_field	Directionality	Threshold	Scope	Processing_function
#Conservation
GERP	GERP
phyloP	phyloP
phastCons	phastCons
SiPhy	SiPhy
CDTS	CDTS_percentile

# Protein predictors
LRT	LRT_score
Sift	SIFT_score
Polyphen2HVAR	Polyphen2_HVAR_score
Polyphen2HDIV	Polyphen2_HDIV_score
MutationTaster	MutationTaster_score
MutationAssessor	MutationAssessor_score
FATHMM	FATHMM_score
Provean	PROVEAN_score
Mutpred	MutPred_score
CAROL	CAROL
Condel	Condel
M-CAP	M-CAP_score
MetaSVM	MetaSVM_score
MetaLR	MetaLR_score
REVEL	REVEL_score
VEST4	VEST4_score
MVP	MVP
PrimateAI	PrimateAI
CardioBoost	CardioBoost

# Functional
fitCons	fitcons
LINSIGHT	linsight_g
ReMM	ReMM
GWAVA	GWAVA
#FATHMM-MKL	fathmmMKL
Eigen	Eigen
FunSeq2	funseq2
CADD	CADD_PHRED
DANN	DANN

# Splicing
HAL	HAL_DIFF
SPIDEX	dpsi_zscore
dbscSNV	ada_score,rf_score
MaxEntScan	MaxEntScan_diff
SpliceAI	SpliceAI,SpliceAI_ind
S-CAP	SCAP
TraP	TraP
MMSplice	mmsplice_deltaPSI
kipoiSplice4	kipoisplice_4
